昆山高新区吴淞江学校（初中部）	初中
昆山开发区青阳港学校（初中部）	初中
昆山市兵希中学	初中
昆山市城北中学	初中
昆山市第二中学	初中
昆山市淀山湖中学	初中
昆山市费俊龙中学（初中部）	初中
昆山市葛江中学	初中
昆山市花桥中学	初中
昆山市锦溪中学	初中
昆山市娄江实验学校（初中部）	初中
昆山市陆家中学	初中
昆山市鹿峰初级中学	初中
昆山市蓬朗中学	初中
昆山市石牌中学	初中
昆山市石浦中学	初中
昆山市亭林中学	初中
昆山市新镇中学	初中
昆山市秀峰中学	初中
昆山市玉山中学	初中
昆山市张浦中学	初中
昆山市正仪中学	初中
昆山市周市中学	初中
昆山市周庄中学	初中
江苏省昆山中学	高中
昆山经济技术开发区高级中学	高中
昆山陆家高级中学	高中
昆山市第一中学	高中
昆山市费俊龙中学（高中部）	高中
昆山文峰高级中学	高中
昆山震川高级中学	高中
昆山高新区美陆小学	小学
昆山高新区吴淞江学校（小学部）	小学
昆山花桥国际商务城花溪小学	小学
昆山经济技术开发区包桥小学	小学
昆山经济技术开发区实验小学	小学
昆山经济技术开发区中华园小学	小学
昆山经济开发区世茂小学	小学
昆山开发区晨曦小学	小学
昆山开发区青阳港学校（小学部）	小学
昆山开发区世茂蝶湖湾小学	小学
昆山市巴城中心小学校	小学
昆山市柏庐实验小学	小学
昆山市城北高科园中心小学	小学
昆山市城北中心小学校	小学
昆山市大市中心小学校	小学
昆山市淀山湖中心小学校	小学
昆山市花桥中心小学校	小学
昆山市锦溪中心小学校	小学
昆山市娄江实验学校（小学部）	小学
昆山市陆家中心小学校	小学
昆山市南港中心小学校	小学
昆山市培本实验小学	小学
昆山市蓬朗中心小学校	小学
昆山市千灯镇炎武小学	小学
昆山市千灯中心小学校	小学
昆山市石牌中心小学校	小学
昆山市石浦中心小学校	小学
昆山市实验小学	小学
昆山市新镇中心小学校	小学
昆山市玉峰实验学校	小学
昆山市玉山镇朝阳小学	小学
昆山市玉山镇第三中心小学校	小学
昆山市玉山镇第一中心小学	小学
昆山市玉山镇司徒街小学	小学
昆山市玉山镇同心小学	小学
昆山市玉山镇西塘小学	小学
昆山市玉山镇新城域小学	小学
昆山市玉山镇振华实验小学	小学
昆山市裕元实验学校	小学
昆山市张浦镇第二小学	小学
昆山市张浦镇周巷小学	小学
昆山市张浦中心小学校	小学
昆山市正仪中心小学校	小学
昆山市周市华城美地小学	小学
昆山市周市镇永平小学	小学
昆山市周市中心小学校	小学
昆山市周庄中心小学校	小学
开发区中华园幼儿园	幼儿园
昆山博顿幼儿园	幼儿园
昆山大公翔艺幼儿园	幼儿园
昆山淀山湖中心小学校花园幼儿园	幼儿园
昆山东方合丰幼儿园	幼儿园
昆山东方剑桥中城幼儿园	幼儿园
昆山高新区翰林幼儿园	幼儿园
昆山高新区鹿城幼儿园	幼儿园
昆山高新区美陆幼儿园	幼儿园
昆山高新区南星渎幼儿园	幼儿园
昆山高新区前进幼儿园	幼儿园
昆山高新区新华舍幼儿园	幼儿园
昆山国际学校附属幼儿园	幼儿园
昆山花桥曹安幼儿园	幼儿园
昆山花桥国际商务城花溪幼儿园	幼儿园
昆山花桥国际商务城聚福幼儿园	幼儿园
昆山花桥国际商务城鑫苑幼儿园	幼儿园
昆山经济技术开发区蓬欣幼儿园	幼儿园
昆山经济技术开发区世茂幼儿园	幼儿园
昆山开发区包桥小学附属美华幼儿园	幼儿园
昆山开发区晨曦小学夏驾幼儿园	幼儿园
昆山开发区晨曦小学幼儿园	幼儿园
昆山开发区东部新城幼儿园	幼儿园
昆山开发区世茂蝶湖湾小学幼儿园	幼儿园
昆山千灯中心小学校美景幼儿园	幼儿园
昆山三之三新城域幼儿园	幼儿园
昆山圣欣美德幼儿园	幼儿园
昆山市爱儿法幼儿园	幼儿园
昆山市巴城镇凤栖园幼儿园	幼儿园
昆山市巴城中心校幼儿园	幼儿园
昆山市柏庐幼儿园	幼儿园
昆山市城北富士康幼儿园	幼儿园
昆山市城北中心小学校幼儿园	幼儿园
昆山市大市中心小学校附设幼儿园	幼儿园
昆山市淀山湖中心小学校幼儿园	幼儿园
昆山市东方巴城幼儿园	幼儿园
昆山市东方幼儿园	幼儿园
昆山市枫景苑翔艺幼儿园	幼儿园
昆山市汉浦书香幼儿园	幼儿园
昆山市红峰幼儿园	幼儿园
昆山市花桥中心小学校幼儿园	幼儿园
昆山市机关幼儿园	幼儿园
昆山市江南春晓幼儿园	幼儿园
昆山市锦华幼儿园	幼儿园
昆山市锦溪中心小学校幼儿园	幼儿园
昆山市陆家好孩子幼儿园	幼儿园
昆山市陆杨中心校幼儿园	幼儿园
昆山市南港中心小学附设幼儿园	幼儿园
昆山市蓬朗中心小学校幼儿园	幼儿园
昆山市千灯镇浦园幼儿园	幼儿园
昆山市千灯镇少卿幼儿园	幼儿园
昆山市千灯镇淞南幼儿园	幼儿园
昆山市千灯中心校幼儿园	幼儿园
昆山市仁宝幼儿园	幼儿园
昆山市三之三大德世家幼儿园	幼儿园
昆山市三之三幼儿园	幼儿园
昆山市圣欣幼儿园	幼儿园
昆山市石牌中心小学校幼儿园	幼儿园
昆山市石浦中心小学校幼儿园	幼儿园
昆山市实验幼儿园	幼儿园
昆山市实验幼儿园金谷园分园	幼儿园
昆山市实验幼儿园澞河苑分园	幼儿园
昆山市私立育英幼儿园	幼儿园
昆山市西塘街小学附属幼儿园	幼儿园
昆山市西湾幼儿园	幼儿园
昆山市西湾幼儿园富华分园	幼儿园
昆山市新镇中心小学附设幼儿园	幼儿园
昆山市星空艺术幼儿园	幼儿园
昆山市绣衣幼儿园	幼儿园
昆山市玉山镇北珊湾幼儿园	幼儿园
昆山市玉山镇朝阳幼儿园	幼儿园
昆山市玉山镇城北福娃幼儿园	幼儿园
昆山市玉山镇城中幼儿园	幼儿园
昆山市玉山镇城中幼儿园共青分园	幼儿园
昆山市玉山镇第三中心幼儿园	幼儿园
昆山市玉山镇第一中心小学校幼儿园	幼儿园
昆山市玉山镇司徒街小学附属幼儿园	幼儿园
昆山市玉山镇童心幼儿园	幼儿园
昆山市玉山镇振华实验小学附属幼儿园	幼儿园
昆山市裕元实验学校附设幼儿园	幼儿园
昆山市张浦镇第二幼儿园	幼儿园
昆山市张浦镇锦程幼儿园	幼儿园
昆山市张浦镇周巷小学附属幼儿园	幼儿园
昆山市张浦中心幼儿园	幼儿园
昆山市正仪中心小学附属幼儿园	幼儿园
昆山市周市镇光大幼儿园	幼儿园
昆山市周市中心小学校附属幼儿园	幼儿园
昆山市周庄镇中心幼儿园	幼儿园
昆山鑫茂幼儿园	幼儿园
昆山阳光圣杰幼儿园	幼儿园
昆山玉山镇童乐幼儿园	幼儿园
昆山周市宏盛幼儿园	幼儿园
昆山周市金澄幼儿园	幼儿园
昆山周市五丰幼儿园	幼儿园
中福会绿地昆山幼儿园	幼儿园
昆山国际学校	中小学
昆山经济技术开发区国际学校	中小学
江苏省昆山第二中等专业学校	中职
江苏省昆山第一中等专业学校	中职
昆山花桥国际商务城中等专业学校	中职
苏州福纳影视艺术学校	中职